1111111111111111111111111
2.......................2
2.......................2
2.......................2
2.......................2
2.......................2
2.......................2
2.......................2
2.......................2
2.......................2
2.......................2
2.......................2
2.......................2
2.......................2
2111111111111111111111112
