1111111111111111111111111
2.......................2
2.......................2
2.......................2
2.......................2
2.......................2
2.......................2
2.......................2
2.......................2
2.......................2
2.......................2
2.......................2
2.....................g.2
2.P........0....S.....G.2
2111111111111111111111112
