1111111111111111111111111
2.......................2
2.......................2
2.......................2
2.......................2
2.......00000...........2
2.......41113...........2
2........999............2
2.......................2
2..g....................2
2..G.B..0..........413..2
211111113...........9...2
2.......................2
2.P................0S0..2
2111111111111111111111112