1111111111111111111111111
2.......................2
2.......................2
2.......................2
2...g...................2
2...G...................2
2..413..................2
2.......................2
2.................0.B.0.2
2.................41113.2
2.......................2
2.......................2
2.......................2
2.P........0....B.......2
2111111111111111111111112
