1111111111111111111111111
2.......................2
2.......................2
2.......................2
2.......................2
2.......................2
2.......................2
2.......................2
2.......................2
2.......................2
2.......................2
2.......................2
2.....................g.2
2.P........B....S.....G.2
2111111111111111111111112
